##########
#..E.....#
#..##....#
#....#...#
#....#...#
#....#...#
#.##.....#
#........#
#.......P#
##########
