##########
#..E.....#
#..##....#
#....#...#
#....#CE.#
#....#...#
#.##.....#
#........#
#..P.....#
##########
